AFI - Miss Murder: unknown
Aerosmith - Same Old Song and Dance: unknown
Alice Cooper - School's Out: progression
An Endless Sporadic - Impulse: progression
Bloc Party - Helicopter: unknown
Blue Oyster Cult - Cities on Flame with Rock and Roll: unknown
Dead Kennedys - Holiday in Cambodia: progression
Die Toten Hosen - Hier Kommt Alex: progression
Disturbed - Stricken: unknown
Dope - Nothing For Me Here: unknown
Eric Johnson - Cliffs of Dover: unknown
Foghat - Slow Ride: unknown
Gallows - In The Belly Of A Shark: unknown
Goal Song: unknown
Guns N' Roses - Welcome To The Jungle: unknown
Heart - Barracuda: unknown
Heroes Del Silencio - Avalancha: unknown
Iron Maiden - The Number of the Beast: unknown
Kaiser Chiefs - Ruby: unknown
Kiss - Rock and Roll All Nite: progression
L.A. Slum Lords - Down N' Dirty: progression
Living Colour - Cult of Personality: unknown
Lost Guitar Pick: filler
Matchbook Romance - Monsters: progression
Metallica - One: unknown
Mountain - Mississippi Queen: unknown
Muse - Knights of Cydonia: progression
Naast - Mauvais Garcon: unknown
Pearl Jam - Even Flow: unknown
Priestess - Lay Down: progression
Progressive Guitar Battle: unknown
Prototype - The Way It Ends: unknown
Queens of the Stone Age - 3's & 7's: progression
Rage Against The Machine - Bulls on Parade: unknown
Scorpions - Rock You Like A Hurricane: unknown
Scouts Of St. Sebastian - In Love: unknown
Senses Fail - Can't Be Saved: unknown
Sex Pistols - Anarchy in the U.K.: progression
Slipknot - Before I Forget: unknown
Sonic Youth - Kool Thing: unknown
Stevie Ray Vaughan - Pride and Joy: progression
Tenacious D - The Metal: unknown
The Fall Of Troy - F.C.P.R.E.M.I.X: progression
The Hellacopters - I'm In The Band: unknown
The Killers - When You Were Young: unknown
The Rolling Stones - Paint It Black: unknown
The Smashing Pumpkins - Cherub Rock: unknown
The Stone Roses - She Bangs The Drums: unknown
The Strokes - Reptilia: progression
The Who - The Seeker: unknown
Weezer - My Name Is Jonas: unknown
White Zombie - Black Sunshine: progression
